1 1 1 1 1 1 1 1 1 1 1 1 1 1 1 1 1 1 1 1
1 9 0 9 2 9 2 9 2 9 2 9 2 9 0 9 0 9 0 1
1 0 1 2 1 2 1 2 1 2 1 2 1 0 1 0 1 0 1 1
1 9 2 9 2 9 2 9 2 9 2 9 0 9 0 9 0 9 0 1 
1 2 1 2 1 2 1 2 1 2 1 0 1 0 1 0 1 0 1 1
1 9 2 9 2 9 2 9 2 9 0 9 0 9 0 9 0 9 0 1
1 2 1 2 1 2 1 2 1 0 1 0 1 0 1 0 1 0 1 1
1 9 2 9 2 9 2 9 0 9 0 9 0 9 0 9 0 9 0 1
1 2 1 2 1 2 1 0 1 0 1 0 1 0 1 0 1 0 1 1
1 9 2 9 2 9 0 9 0 9 0 9 0 9 0 9 0 9 0 1
1 2 1 2 1 0 1 0 1 0 1 0 1 0 1 0 1 0 1 1
1 9 2 9 0 9 0 9 0 9 0 9 0 9 0 9 0 9 0 1
1 2 1 0 1 0 1 0 1 0 1 0 1 0 1 0 1 0 1 1
1 9 0 9 0 9 0 9 0 9 0 9 0 9 0 9 0 9 0 1
1 0 1 0 1 0 1 0 1 0 1 0 1 0 1 0 1 0 9 1
1 1 1 1 1 1 1 1 1 1 1 1 1 1 1 1 1 1 1 1
